 {
	  "tileNames": [ "empty", "quest", "path-simple", "start", "path-q1", "path-q2", "path-q3", 
				"target-1", "target-2-player", "target-3", "target-4-player", "target-5", "target-6-player", "target-7", "target-8-player", "path-q4"],
  	"tileMap": [
		[ 0,0,0,0,0,0,0,15,0,0,0,0,0,0 ],
		[ 0,0,0,0,0,0,0,2,0,0,0,0,0,0 ],
		[ 0,0,0,0,0,0,0,2,0,0,0,0,0,0 ],
  		[ 0,0,5,6,4,2,2,0,2,6,5,4,0,0 ],
  		[ 0,1,0,0,0,0,0,0,0,0,0,0,1,0 ],
  		[ 4,0,6,0,0,0,0,0,0,0,0,6,0,6 ],
  		[ 5,0,0,5,0,0,0,0,0,9,8,0,0,4 ],
  		[ 6,0,0,0,4,0,0,0,0,10,7,0,0,5 ],
		[ 2,0,0,0,0,2,0,0,2,0,0,0,0,2 ],
		[ 2,0,0,0,0,0,15,2,0,0,0,0,0,2 ],
		[ 2,0,0,0,0,0,2,15,0,0,0,0,0,2],
		[ 2,0,0,0,0,2,0,0,2,0,0,0,0,2 ],
		[ 4,0,0,13,12,0,0,0,0,4,0,0,0,4 ],
		[ 6,0,0,14,11,0,0,0,0,0,5,0,0,5 ],
		[ 5,0,6,0,0,0,0,0,0,0,0,6,0,6 ],
		[ 0,1,0,0,0,0,0,0,0,0,0,0,1,0 ],
		[ 0,0,4,5,6,2,0,2,2,4,5,6,0,0 ],
		[ 0,0,0,0,0,0,2,0,0,0,0,0,0,0 ],
		[ 0,0,0,0,0,0,2,0,0,0,0,0,0,0 ],
		[ 0,0,0,0,0,0,15,0,0,0,0,0,0,0 ]
  	]
}